(FORMERLY CZECHOSLOVAKIA)	CE
AFGHANISTAN	STAN
ALBANIA	EE
ALGERIA	NoA
ARGENTINA	SUSA
ARMENIA	ASIA
ASIA MINOR	ASIA
AUSTRALIA	AUS
AUSTRIA	CE
AZERBEIJAN	STAN
BALKAN	EE
BELGIUM	NE
BOSNIA AND HERZEGOWINA	EE
BRAZIL	SUSA
BULGARIA	EE
CANADA	CAN
CHILE	SUSA
CHINA	ASIA
COSTA RICA	SUSA
CROATIA	EE
CYPRUS	ASIA
CZECH REPUBLIC	CE
DAGHESTAN	STAN
DALMATIEN	EE
EGYPT	NoA
EUROPE	CE
FRANCE	WE
GEORGIA	ASIA
GERMANY	CE
GREECE	EE
HUNGARY	EE
INDIA	ASIA
IRAN	ASIA
IRAQ	ASIA
ISRAEL	ASIA
ITALY	SE
JAPAN	ASIA
JORDAN	ASIA
KAZAKHSTAN	STAN
KYRGYZSTAN	STAN
LEBANON	ASIA
MACEDONIA, THE FORMER YUGOSLAV REPUBLIC OF	EE
MALTA	EE
MEXICO	SUSA
MOLDOVA	EE
MONTENEGRO	EE
MOROCCO	NoA
NETHERLANDS	CE
PALESTINIAN TERRITORY, OCCUPIED	ASIA
PERU	SUSA
PORTUGAL	WE
ROMANIA	EE
RUSSIAN FEDERATION	EE
SERBIA	EE
SLOVAKIA	EE
SLOVENIA	EE
SOUTH AFRICA	SA
SPAIN	WE
SUN (FORMERLY USSR, UNION OF SOVIET SOCIALIST REPUBLICS)	ASIA
SWITZERLAND	CE
SYRIAN ARAB REPUBLIC	ASIA
TAJIKISTAN	STAN
TUNISIA	NoA
TURKEY	ASIA
TURKMENISTAN	STAN
UKRAINE	EE
UNITED KINGDOM	NE
UNITED STATES OF AMERICA	USA
UZBEKISTAN	STAN
YEMEN	ASIA
YUGOSLAVIA	EE